													NO             ./texture/no.xpm
	
	
	
	
	SO 												./texture/so.xpm
					WE 														./texture/we.xpm




F 		0,						0,					255



EA 										./texture/ea.xpm

							C 					124,				0, 										125





							111111111111111111111111
							1000000000000000000000001
							101111000000000000000001
							101  10000000000000000011
							101  10001100000000000000111111
							101111000000000000000000000001
							10000000000000000000001111111
							1000000E0001000000000001
							100000000000000000000001
			1111111111111111100000000000000000010001
							111111111111111111111111
							111111111111111111111111
							100000000000000000000001
							100000000000000000000001
							100000000000000000000001
							111111111111111111111111
