NO /Users/tumolabs/Desktop/suhovhan/cub3d/texture/no_texture.xpm
SO /Users/tumolabs/Desktop/suhovhan/cub3d/texture/so_texture.xpm
WE /Users/tumolabs/Desktop/suhovhan/cub3d/texture/we_texture.xpm
EA /Users/tumolabs/Desktop/suhovhan/cub3d/texture/we_texture.xpm
F 255,0,0
C 0,255,0

111111111111111111111111
1E0000000000000000000001
100000000000000000000001
100000000000000000000001
100000111110000111110001
1000001   100001   10001
1000001   100001   10001
1000001   100001   10001
100000111110000111110001
100000000000000000000001
111111111111111111111111
