NO ./texture/no_texture.xpm
SO ./texture/no_texture.xpm
WE ./texture/no_texture.xpm
EA ./texture/no_texture.xpm
F 255,0,0
C 0,255,0

111111111111111111111111
100000000000000000000001
100000000000000000000001
100000000000000000000001
100000000000000000000001
10000W000001000000000001
100000000000000000000001
100000000000000000000001
100000000000000000000001
100000000000000000000001
111111111111111111111111
