NO ./path_to_the_north_texture
SO ./path_to_the_south_texture
WE ./path_to_the_west_texture
EA ./path_to_the_east_texture
F 220,100,0
C 225,30,26






11111111111111111111111111111111111111111111111111111111111111111111111111111111
11111111111111111111111111100000111110000000000000111111111111111111111111111111
11111111111111111111111111E00000011001111100000000001111111111111111111111111111
11111111111111111111111111111101000011110000001000100111000001111111111111111111
111111111111111111111111111111110001    1000000000000010000001111111111111111111
11111111111111111111111111111110000011110000011100000010111111111111111111111111
11111111111111111111111111111101100001100001111001000001111111111111111111111111
11111111111111111111111111111101000000000100111110000000111111111111111111111111
11111111111111111111100100011111100000000000000000000000111111111111111111111111
11111111111111111110011111110011110000000000000000000001100010111111111111111111
11111111111111100000011000100011111110000011111100000000010010001111111111111111
11111111111100110000100000100011111111110000000000000001010000111101111111111111
11111111111001110000001001000011111111111111111100000011100000111111111111111111
11111111101111000001001110011000111001111110000000000010110101011111110111111111
11111111111010000110100101011001100000000000100001010010111110001011110101111111
11111101110000001100111111011100110000000000111001111001101100000000110110111111
11110011000000011100001110111111100000000011110011001100110110000000111101101111
11110111000001110100010100111011010011000111010001111111111111111000001011100111
11110111000000011111110011100101000000101010111110001111111100111110000011111011
11110000100000110110000100111000000000000010001101110000011110001111000111110111
11111000000000011000000000000000000000000000000100011101111110011100001111111011
11111100000000011100000000000000000001010011111111111011111110010000000111100111
11111111000000001100000000000000000000110111111111111111111000100000001000000111
11111111000000000010000000000000000000101100111111011111011100100000110000011111
11111111100111111110001000000000000000111111111111110111111001000000000001111111
11111111110000001111011001101000000000000000111111011101100011000000100111111111
11111111100000001111011111111000000000000000000100000000000010000000101111111111
11111111110000100000000011111110000000000000000000000001111000000000111111111111
11111111111111111110000010011111110000000000000000011110110000000001111111111111
11111111111111111100000000000000000111111100001001011110111000000011111111111111
11111111111111111100000000001000010000001000000101111111111000011111111111111111
11111111111111111111111111111111111111111111111111111111111111111111111111111111
